11111111111
10002000111
10111110001
10000011101
11011000101
10101111101
10101111001
10101011011
11101010001
11111021111
11111111111