11111111111
20000000111
10111110001
10000010111
11011000111
10001111111
10101000011
10000011011
11111010001
11111000101
11111111121