11111111111
20000000111
10111110001
10000011111
11011000101
10001111101
10101000001
10000011011
11111010001
11111000102
11111111111