11121111111
10000000111
10111110001
10000011111
11011000101
10001111101
10101111001
10000011011
11101010001
11111001111
11111121111